                                     _____________________
                                 .../                     \...
                            .../                               \...
                       .../                                         \...
                  .../                                                   \...
             .../                                                             \...
        .../                                                                       \...
   .../                                                                                 \...
 /__________________________________________________________________________________________\
|                             |                             |                                |
|                             |                             |                                |
|                             |                             |                                |
|                             |                             |                                |
|          UPSTAIRS           |           BEDROOM           |            CLOSET              |
|          BATHROOM           |                             |                                |
|                             |                             |                                |
|                             |                             |                                |
|                             |                             |                                |
|                             |                             |                                |
|                             |                             |                                |
|                             |                             |                                |
|                             |                             |                                |
|_____________________________|_____________________________|________________________________|
|                             |                             |                                |
|                             |                             |                                |
|                             |                             |                                |
|          KITCHEN            |           LIVING            |            BATHROOM            |
|                             |            ROOM             |                                |
|                             |                             |                                |
|                             |                             |                                |
|                             |                             |                                |
|                             |                             |                                |
|                             |                             |                                |
|                             |                             |                                |
|                             |                             |                                |
|                             |                             |                                |
|_____________________________|_____________________________|________________________________|
